##################################################
#  #######   #      #      #   L    ###### *    *#
#  ## #      #             #     .   .#  ## .#   #
#  #  #      #.   * ##### .#   .     #####*      #
#  ##  \    .#             #         *#    #######
## ##    # ###*     .   #  #    # #   # ####### \#
##    .# #       *.     #  #      #  #   #  . #  #
##     #   \###      # ## .       #  #   #.   #  #
## ### # . #        *#####   \ \ .#  ######   #. #
###### #   #*# .     #######       ###   #       #
#  # ##### \ # #\ #  ###\ .        ###   #       #
#  # # # ##### #  #  ###.  \   . # #######  \ .  #
#  # #   #   # # ##   #          # ## **         #
#    \ . #     # #  #####\            R  .       #
#####    #       #           *             .   ###
#        #       #              .      #        *#
#   #       .    #######   .   ####### #         #
#   #            #                \    #  #      #
#   #      * \   .                ######  #    \ #
#   #          . .   ######\ ####   * ######.   \#
#  #####              ##########\  \  #.   #     #
#   #  .     \     #####* # *   #    *#    #*    #
#######.          ##     #####  #  .    ##########
# #   .      .    ##  #  \ .#####          #   # #
# #\ \  \*   \.  ###  #      #  #     ####     # #
#\ ..   ####  *  # ###     .#####     .  #  #  #.#
#                #     \      . *     *  #  ######
#  *       #     #  * ######       .##.  #  # ##\#
# .  .    ###  *#.  . #        ###    .  #.*######
#   *    *## ####  \  # #### #######      **# #..#
#   *     ##    #    .#  #.*####    ###### ####  #
#  ###  . ###.  #  . ##  #. # ##*  ####    ##    #
#. #      # .   #    #   #   #        ### ########
#  #    .        .     . # .   .  .######  #   # #
#  #                  #######*          # ###### #
#  #             #### #*    ##      \   #. #   # #
#\   .      .    .    #           ####### ##   # #
#       .    .# ##    ##       .   *    # ###  # #
#\   #  .\ #  #  .     #           ###### ###    #
# \  #  . .# # *      # ######           *########
#    #   # # #     ######  #################   * #
#    #*  # # #  **    #.#      ####     *        #
#. * ##    # #   \\  *# #    ######   .     .#   #
#        . # #.      .#   .      #       ######  #
##      #### #           .  ### *  .    . .  #   #
##          #####    *.   . .     *     ##########
##  .      ###########      .    \        ###    #
##       \.   \   #### .       ######          . #
#           \                     *              #
##################################################

Water 10
Flooding 5
Waterproof 50