##########
### *    #
###   \ \#
#    *  .#
# .*.###\#
#. #  \ .#
L  ##*   #
#  ### * #
#      .R#
##########

Water 0
Flooding 1