##########
# #*     #
# R  L   #
####   \*#
####  **##
## #   # #
## # \## #
####\*#\ #
## ..##  #
##########

Water 0
Flooding 2
Waterproof 3