#####################L############################
# . #.. . # *####.... .##     #.  \ *   #.  . \ .#
#.  #   ####*## #. ..  *#######..   ### #     . \#
# \##.  . . * # #.... ######  #     .  .#   .  . #
#  \.\ * *. ..# . ####  ########  .  . ..   .*   #
##   .    ..  #  ... ..   #..\   . .. . #. #######
## .. .  .   \#####. *\ *  ###### .C ..\#      . #
# *#.#\. .*.. #  \        .#\    ######*##.. . \.#
##################################################
#  #*.  #.##  #.  *\#  . * # \# *   . #### #. . ##
#. #  #  .#.. #   .*#    . # .#.  . *\.###.#.\ ###
##.*. # ###*. # .  .# \. . # ####.. \   ##.#   ..#
##. \ # . ### #*. ..#    . #. .#     .  ## ###.. #
##.. *.   # *.# . *.#\.    .   \.#. \*.* #.###.# #
##\. .  * ##  # ## .#   .  . *  .#.#. .  # ###.# #
##  .  .   # \#..  ..  .###  .. .# # * . #F## ## #
##..   .   # .#  . ######*  . . .#.#.*  .# # ### #
# ##*. .   #. #  .#  .  #.. .    . # *   #.  ### #
# 1\  . # \#### . # ... #  #* ###. #.. #  .  ##. #
#  ..  .#**.* #   #. . ..  ######.#. .##  . . # *#
#   . .     3 #   # . . .  \.**..## .*## # ####\.#
##..\ . * .* .##*   ####       ####.*.#  # *  .  #
##  \.*..    .##    # \ ##.....  ###..#  #    .  #
##\ ... . ..#.##.*.#     \ .\.\  ###. \  #  ..   #
##  * ** * \#*##   #   *.. .  .  #.   .\. \  *.  #
####\ *.  ..# ##. .  * ..*  # #. #.      ...    .#
#      . . .# ##  *#. .     # #  \ #    # \.   . #
# ..\\#.  *   # .########   #.#\.\.#    #      . #
#     #...\  .#E.\# .*.#### # #* ..#. ###   . ####
## ...#*   .  # .\#*  ..   .#.#    #.# .# ...   .#
## .  # .#   .#.    \. *. \.. \.   # ## #* . *.  #
##  . #  #*.  # ..  .   *.      \ .# ## #.\   .. #
##*.  #..# . .# .*.####        . . # ####### ###.#
## .     #. \\#      ########. \\*.#.########    #
##.    . . .  # #*  #### #.. \  .   2##*..  .... #
##   .   ##\ .#.#..\ ..# #   ####.    # .. #.   *#
# *.\..\#######.####.  #       .  .D. ######  .. #
# *   .    #.\#.#### . * . #####.   .*#..  # .   #
#    ...\ .#  #.# ### .. ...   \ ..### #*\. \ #.##
#.     . *## \#.# #.#     .  .###  #   #   \\ #. #
##.######.    #.* # .\  . * . ..   #. .\\.*    R #
##   .\ .  .\ #* .###   \\ ... \ * ##\   #. .  \.#
## . \.\.  .  #* .     .BA  .    . #    .#       #
#.. . ..  ...\#      #  .   .\.....#   . # #. .# #
#\ # ..   ##.######. # . \.  .\  . .    .##### # #
#. #  .  .#######.   \\..*..  .     ## \ .#####* #
#  #  \\#######. \  *  *    *\\. .#### #  .#..  .#
#...... .* #  #**  *.######       ..  \#..4#    .#
#   .  * . . *#.    .  .   .     .\.  .#   # *   #
##################################################

Water 0
Flooding 2
Waterproof 10
Trampoline A targets 1
Trampoline B targets 2
Trampoline C targets 3
Trampoline D targets 4
Trampoline E targets 4
Trampoline F targets 3