####################
#.  * .     # .### #
# *    . .# # .### #
#.  A #   # #. #   #
#   L##.  # #\   # #
#  R  #   # ## . # #
#          .# .  # #
#  . \\\   ###* . .#
#\*# . #    ####.  #
#  ### #  ..##.  . #
#  #.  #  #\#. . . #
#  *   .  # #..#.. #
#   .      .# ###  #
# .  \... . #   #..#
#      ..   # ..#  #
#   *\   .*.# . 1* #
# \##*.\   .#      #
####################
#  #    * ###  .  .#
####################

Water 0
Flooding 0
Waterproof 5
Trampoline A targets 1