#################L################################
#*###\  #    #    **  . # .  ##    ##   ##########
######    ######        #######     #  *  #.#    #
#   #    #   #.  ###   \#  * .  #.  #. # \# #  # #
#   #    #  .#   #      #    *  ####  ##  # ## #.#
#        #   #   #  ##  # *.  . #     #   #### # #
# .   #  #  ## . #  .           #  *  #      # # #
#     #  #  #    .        ###   #     .      # # #
# #   #*### #   * .           . # #     *     \# #
# # * #.\                \   .  #.#      #####   #
# #      .     # #####\     .  \# # .     \      #
# #          # #         .    *#####             #
#.##     #\  #     .###.  #####.       #        ##
#        #  \# .# \       #######     ##        ##
#.       #   #  #   #    *   #*##              . #
#        #      #   #       ####  \####        ###
###   ######   *    #  #     #        .*  *   ####
#  . \   #      \.  #  ##  . #     \      #. .   #
# *   ####             ##        .       #### \  #
#   . \######       . *##    . #  .     * #      #
#       #\   #         ##  ##  # ####   *  #.  \ #
#.      #    #       ###### .  #  #  #     #  .  #
#.   ..\     #  \           .# #  #  #     #  .  #
# ## #      ######        .\ ######  #* *  . #   #
#    #      ###### #         # #  #  #   .   \# ##
#    #  #  ####### #    #    # .  # .#       \# ##
#    # \# * #   .. #.   #    #   .  ####   * \  ##
#  ..#  #*  #       . * # \ ##           .      ##
# # ##  #  *# *   # .#  #   #####  * #   .  ..   #
# # #####   # #   #  #     \#   #    #  #####*   #
# # ##### .   #   . # \R##  #.  #    #   .       #
###\###       #*    #  #######  #    #  #       \#
#. * ##  #    #   #####  #  #*  #    #  #.       #
# #  ## *#    #  \       # \    ## .  . #**#  ## #
# #  ##  #  ###          #      ##         #     #
# # .##  #     #  . ###############        #   . #
# ##########   #     *  ###     # ##       #     #
#.#  * .  #   #### \   .      # ##   .     #     #
# #       #    #  \           # ########## #.    #
#   \          #    *   #    ####        ###     #
#  #     *       . \    #  #  # *. ###   ##  \  *#
#  #    #####         \  ##              *##\#  \#
#  #      #### \ *            .           ########
#  #.#   .               .  \          ###########
#    #  ######\    #     . #    * . .      #* ####
#### #      .    #####    ##.  \           #   * #
# ####            #####   ##  ###  \      \#######
#    ##    ##       #     #.  *   .             .#
#         .      \  #### ##   \                  #
##################################################

Water 25
Flooding 1
Waterproof 1000