####################################################################################################
#               #                                                 *     #   \     \                #
#  #        .#        #              #                             # .       . .       #           #
# #  #                       #   #      #          #      #                             #          #
#     #                     .                 #                                       ##           #
#      #                                           # ##       #                            #       #
#           #                   .                   #          \    \              #         #     #
#   #       #                 *                                     #                              #
#   #                  #     #             #                                       *               #
#     #               #              #            #*  #                                 .        # #
#              #                      #     #           \     \       #      \                     #
#          #                                           \  * #.  .#                      #      #   #
#        .                     .   #        \                   #               *                  #
#*    #         #   #.                                                     .          \            #
#          #           #      #                #                 #           #           #        ##
#                  #               #           #          #     #        #        .         .      #
#                                                   #           #       #                #  #      #
#     *                     *     #          \ #                                                 ###
#    \                #               #    # #    \      # #                                 #     #
#   #        *                #        #      #             .    #               *                 #
#    #    #                        #              \#     #         #                 #             #
#   #               .                *                      #                            *    #    #
#     .           #      *\                       #         #                                 #    #
#    #         # #          #  #                 #     *         .\#          .                    #
#              \            #        \   ##             *                      .    *   *          #
##          #          #        #          #                           #                          ##
#                                               #    # .                                  #        #
# ## #                                                        #                                    #
#                 #     #                  #         #                    #        #               #
##       # #                            #               #                    #   #            #    #
# .             #            #  *                               # #                 #              #
#.                  .                     \                  #     #       #    #                  #
#                             * #  #  #                   #         .#           .                 #
##                       #      #   #                                                        #     #
#                       .    #                                 #  #  # ##          #             # #
# #  ##         *       #              #          #                 #          #       #           #
# #   #                                       #                              .#         #        # #
#         #        # #          #               ##         #                   #            #    # #
#             *        #                                                       #                   #
#  #  #  .                   .    \   #              *##   #                    #                  #
#                                        #   #        .       #                     #              #
# #         .                    #         #                        #  \ \                         #
#     ##                  #           #                  #   #                                     #
# # #     #                      #                  .           #                  #         *     #
#                                        #  .    #              \                                  #
#                 #                   #                                           #  ##            #
#                                       #                       #                 #                #
##           #                                #    #                          . \              .   #
#   #    .     #           .      #     #   \                   .       #            .     #.      #
#                  #                            #                                 #         .   #  #
#   #    \ #      #      #         #      *          \*                                   #   .    #
#    #     #    #           * #        #                                                          ##
#  .  #     *  \                             #     .        #                 *                    #
#       #  #          #      #                          # #             #              #          ##
##               #                           #*    #      .  .                      \     #        #
# .       #                 #                           \ .    #             #                     #
# .  #                    #             .          #\                              #  # .        # #
#    .          #                    .                                    \*      #    *      .    #
#                      ##                                        #      .  \               #      ##
#        #      #         #       #  #  .              #                  .           #  #    #    #
#                                       #                                      #              #    #
#                 \                       .                  #      #      #       \         .     #
#            #       #                #   #                      .                                 #
#       . #     #                 #           #                                                    #
# \          #            .                    #  *    #         #                    #            #
#           . #    .   ##     #                                                           \      # #
# #        #                                                #            .     #                   #
#                                    #  #    \  \                                                  #
#   ##          .                      .                #         \           R  #   #             #
#          #    #      .         *                                           #   #      #          #
#                                                                                              #   #
#              #                               #  .           *   #                                #
#  .                #                           #  .            \     .   #        #               #
#      # #. \                       #           #                    *              #              #
#             #           #             .                      .                 *    .            #
#     #        #                    #   .      #  #             #    #                    . .  ### #
#                      #             #   #   #                     #                      #        #
#                                                     #       #                                  # #
# #             #       #   #    *                        #     #.    \     #                      #
#   *#                                                   #                                     #   #
#               #       #                        #   # #             L#           #       #    # # #
#                            .                                                    #        #  #    #
#                                   *#              \   #  .                       # .             #
#          ##                       .                          #              #         \  #      ##
#     .   *                   .                    #         #           #         *      #        #
##         #      #                   ## *                   #    #          #       #    *  .   # #
##         * \ #      #                   *                       #       #      #         #       #
#                          #                       .     #              #  #         *             #
#            #      #         #  #                   #      #          #           #               #
#           #          .    ##                  #                         * .     #        #       #
#                      #     #                                       #             #           #   #
#     #       #                 #   #      #                #      #           \    #              #
#                #       .   #            *                                      #       .         #
#        \                                       #         *       #   #            . #            #
#        \               #              .  #  #   # #      #        .#  #         #  #     ##      #
#                 #     #                # #                      #                      #  #    . #
#                                                             #      #    #  .                     #
#                           #       #   #     \       #           .                  #             #
#                     #       #                                                 #         #        #
####################################################################################################

Water 0
Flooding 1
Waterproof 5