##################################################
#  *  ######.###. #*.###    #  .. . .. # #######*#
#..    ..    ###. #. ..    .#*  * *###### .#   # #
#  ####. *\ .   * # *    * .#      . * #    .  . #
#* * *  *   ###.  #.*#### ..#  ####*   # *.    . #
# .#####  #### * .########* # .# . . # ######    #
# ..*###### ..     ..########. #     #   * .\#   #
#    #*              # ... .*  #*.**.# .*####### #
# .. #   *   #.  **######      #\.   # . #####.  #
# *  ##* . ..# .    *#.. .*     .\.      #. .   \#
#   ### .    #  * ## #*...*  . *. .  .*  #####   #
# * #.   . . ####    \       * ..  .     #.. . # #
#\ \# #####  #* ** .*  . #   #. **############ #.#
#...# \  .* .# ..###### ##.*######   .\  .  \. # #
#  \#   ###  # \ #.     ##        . . .*. R . .# #
# * .. .## ..#  #####. * #..* #####**.## ... .####
# . #.  ##   #    ###### ###  # .   *\. .*  *#...#
#   #. .##.  #      # .# #  * #  .  * .. . ..#   #
#   #.  ##    *. *.######  .  # \.. #  .# * .#  .#
#  .#    # \   ####*# .    \ .#  ** # * # ####.* #
#  \###### . .    ###.        #..   #   #.   #   #
# . # \  #  * .  .  #. *  .. *#. . .# * . .  #####
#*   .#####  #### \.#  ## *  ####. .#  . .*    \ #
#   .   .\. #    ..#####  . .##*#######*    ####.#
#   .   .. *#.  *  .#  .*###.## #  \     . * * # #
#      .  . #  *    # .#  .  ## # . . .*     . # #
# . .*\   * #  *   . ..# .   ##    * .. *.######.#
#. . *  .* ##\.    * . *. . ..  ...    .  * .\##.#
#.** .* * #####.    ##. . *      #. . * *  ..#####
#.      ..  \ ####.. .   * * *   ## .    .. .  #\#
#.  .#  .   #.#    *.    .#.   .### ... ###### \ #
# \* #  **  # #..*    \   # #.  ###  *#    #######
#######* #*  ###..   *###.# ## *###.  #*  .#    .#
##.*. .####    *.*.    . #  ##. ###*. #   ###* . #
##*..   **   ##\** ..  . #####* #* ##.#  ..  #.#.#
##..  . .*  ..      * **.# .## .# #.  # . * .# #*#
#   . ..    * *  \. *  * #  ##  \ #. *#. # . #.# #
#  . .*     *## #####* . #.  #  # #*  #.## **# # #
#####   *.   #  * .\ *###.  \ * # # . #. # \\#*# #
#.  . .. ... #.*. * . #   * .  .  .* .#\    # .#.#
# #* * *     * *######   *####  * *.####   .#.   #
# #####    **   ** \..  #*# * *.  \ *    .*    ..#
# ## ###..\  *   . ###### #.*   * . \   *. . .   #
# ##   *..   *  ...  .  #     L  ##.** ..   * ..*#
####   #####   .\ .. .* .. \*#  .##  ..#  .. * . #
# . ... .    \  .**  ..    * ##  ##  ######.### ##
#  * #    *  . .. ###### # . ##  ##.\  #   .* .###
# .  #  *  .*.. \* .  *  #    #* ##.####....   *##
#.#### *  .     .  . .. \#    *  .#\# .#  *    *##
##################################################

Water 0
Flooding 0
Waterproof 0