##################################################
# *  #* ## .     #..  ..##### #. ##########  .\\##
#*. .# .## * ..####    .   #.\#  1 .   *\##   *\##
#  .*#     .  *.###. .\ ##  ..#.. . . .  ##   #.##
#..*\ ...  ..  .\#####. . . ..#       \# ##   # ##
#\.   .\ # * .  .#\#.  #......# .*.... #  . ######
#.. .### #   .\ .# #   #########  .    # .  . # ##
####  .  #. .  .## ### #   . \ .#  . ..#* . . ##.#
#       ## \ . .##*## .#.  \.\  #..  . #   #######
#*.   . \#  .   \#  #  #\. ..# .#. .#### .###### #
# .   .###    .. #   .##  #. #. #.   .   *# .  # #
##################################################
# \...   . *  \.*#   ##.\.#  #  *. .    . #..### #
#. #.. .#5.......#.# ##  *#  # .*  * .   ## \# ###
#  # . .#.* ##**.# # ##   #  # .   . 6.. ##  #. .#
# .#  #\#  ..  \.### ##\.##. # F..       ## .#** #
#*   .# # .  ... ### .#\ #.. ##  ##       # .#  \#
#.. . . # ..   # # . .   # . ## ### *######  # ###
#   ..  ##.    ### . ...  ##*##  \##   ...######.#
#       \#   ... #.. . *  . \ # . ##   *  #.*.   #
# ####  ##.   \ .#   . .*     ####D#... .####. \ #
#.  *. . #  C..  #  .    #####..   #     ##...# .#
#* . .    *####\ #\ ##########\ *    . #####  ####
##.\    ...\  .# #*. #  \## . .. . # .* .\#  .#  #
## \* .##   . #### * #  .###  \# ..#. *   #..  # #
##*  #.  \ ..  ###  .# .*.## . #.  ##### .# .  ###
###  ## \ .. #########..*  #. ## .  *\ . #    .###
###\.##.######.# # ..#  E.B# \##\ 3  ###### .*.###
###\# #.. # .    ##  # .  #.. ##   .  . .    . ###
#.# #.2* .# .. ..##  # *. #*..# . .  .   .   \. .#
# \.#\.. *#..   .#..  \ ..# . #        ..##### ###
#\  # . . #  * * #. .  .### ####.... .    .  * .##
#  .. .\. # ... .#\     #### .. .  .*  \ # ####..#
# # ####. ####  \#   *.     ....  * . .* #   .#  #
#.#    *. .  #.  #\\    . *  A  ... .   .#   .#\ #
#.#. .  *#####..\#  \*    * \4 .#####..  ###\ #..#
#*#.    . .. # * # .    .. . .    .L \.. ###   . #
# # . ..  .. ###.#  \.  .   .  *   ..    ###\ *. #
# #. .   . . #.. # \   ######  \\\ * .**..##### .#
#.#      .\  #...# .   .  .* \     \\   \ . * .  #
# #. ....   .# # #. *   ####. . .**   *.######\\\#
# #.   *  ...#.#########  *.  .    . ######  .* *#
# #      .   .######...###.  . .*     . . *     .#
####  \.  . .  #### .. #  \.*. .    ...     .* \.#
#  *  ..## ....*##     # #      R  ###### *..\\ ##
# \   \.#####...## .     #   ..  \  #####  ##\ ###
##### \ .*\.. *.######   ##.\... .. .*.* . * . # #
#.    \# .  . .\ # ..    #  .*.\ ..   \ . \.\ .# #
#  *. .# * * ...*#    . . .\.  *..   .  *.  ####*#
##################################################

Water 0
Flooding 2
Waterproof 10
Trampoline A targets 1
Trampoline B targets 2
Trampoline C targets 3
Trampoline D targets 4
Trampoline E targets 5
Trampoline F targets 6