##################################################
#  . * *   # .. #   \  . .              #######  #
# *.   # * *  .  .      #      #####    # # . #\ #
#     \########     #####     #         # #   #  #
#  .#####  ###### *     #     #           #   ####
#  *#   ##### .       \ # # * #          #       #
#   #     .  *    ###   # #.  #        . #   \\  #
# #######  #   .      *.  #       \      #  #    #
#   #      #    .         #      ######     #    #
#  *##\ .  ##  #### .  . \# . #####      \\ ###  #
#          #   ###       .# .####    .      .## .#
#    .   . ######            #######    . #####* #
#  #      .#       ###   ###### \  # #      ######
#  #   #   .  ######     # #   R   #.      . #####
# ######        **       # ######  #\  \  #  \ ###
# .######     . .        ##### #   #      #     ##
#*####     *#    *.\..   # # ##### # #  # .   # ##
# #   #\ ##.#  #         # #  .   .  #  #  . *# ##
# #.  #    .#  #      \    ##       . \ #    ## ##
#  ######## #   .* \       #      .    ##### ## .#
#  #  \  *  . .  \     .   #         *  #    ##  #
#  # #        ####     ..   #         ##     ### #
#  # #   #  ######      #############         #  #
#  #\#   # .        .   #   # # #.   *  *#    #  #
#  # #   #.      .\     #  \# # #  ###  ####  #  #
#  # #      \     . .     . # # #        ######  #
#  #    ## #    #                 \       ###    #
#  # * #####.   #                               ##
#               # . * # . .\\         #      #   #
#               #    .# #    .      ..#      #  .#
# #   *   *     #     # # .*      \   ####   #   #
# #     ####    #       #             #      #   #
#\#           ######    #          *     .   #  .#
# #   #  #### * #####   #          . .           #
#     ###*     .#  #######           #     #######
#     #####.  #.#### #       \.  ######* *       #
#     # # #   #  . \ #       *#  #    ######*    #
#      ##     # .    #  ##    #### ####        # #
#     *#    . #      ## . \   #  # ###         # #
# *    #  #   .       ###    .#. # # #    ###  #*#
#      #  #   *    #####      #  #    \#    ######
## \   #  #  * *   ##  # ######### #####  L    # #
##\       ###*\ .\  #* #      ##     # #       #*#
##     ##### ###    #. #  .          #####     # #
##\    #    ###### ######          . #.#         #
##     # .      ######    *##      ######.#####  #
#  .   #  *                     ####### *######* #
#.     #       #####  *  .                ####   #
#    . #          .             ######        *  #
##################################################

Water 10
Flooding 5
Waterproof 0