##################################################
#. . . .B ...###### ..  #  * .    F* .. ..# #  ###
#.   . ..    #.   # . . #. .. \ * .   .   # . .  #
#.### \.   C # \ . # ... .....    *##.. . # .. .##
#  **##   \.  . ...#.    #   .. .   . .   # ..   #
##.  .#\    .. .##### ...# # .. .  * .    ########
##  ..#. ..\.  .  .# .. .#\# ...##  .   ..#.  #..#
## \ ##...A   ..  \#.. . #.# ######## .. .#.  # *#
## ..##.##*.....#\  ###..# #......*    \# #* .#\ #
##.  ###  #...  #*#..  * #2\ *   # ..   # # ..# .#
##. ###. .#   ..  #...*  \. *. .### ... #.#. #.  #
##   #*   #  * *. # .*.# ###  . ..   .  #.#. #.. #
##  \*.   .####.  .. . #  ....  ..        # .# ###
########...  ####  . ###### .    .. .   . #..#.. #
##.##. #  #####   ... .#.** .   . ######..#* # . #
#.. . .#     .# *...\  #   # ..*#####. .. ##.#*. #
#...##.##* .* #.   .* ...\ #. ... .      .##*. * #
#  ###.##  .**#.  ## ..\  .#..#   . * .##*##*  .##
#   .\. #. \*....*##    .  #*.#\. .\. ... ## .# ##
#...   .#  *  .  ###  . ..##  **###  . .##### # ##
#. ..  ###*  *.   ## .. . # #####  .    ..##* # ##
##    .##   . ###*## .    # # . # ... ############
##  .  \ .    ..    .# .    #  .#*  *.. . ##..#. #
##   ..   ..  \  .   #L   #.  . ### #.  . # ..  *#
##.   .*    .  .*..  #  ..#  *\. .\ #.   .#####  #
#.  ###    . * ..   *#.*. #       ...#### #.# ##\#
#.  ...   #..  .* . ##### #.. * .###\   # # # ####
#. ... #..#.. ..  .  #.\  #*       .. ..# #. .. .#
## *  .#  # ## #### .#..  # *.# .  .  . #.# ...3*#
##...     # .  ..*. .    ..  *#. .*    ## ###  ..#
##*.\\... ###### .###    . *  #.  .. \   \# .\. \#
#      \. #.          ####### ... .. *. ..#   .\##
# .  . .   .  *..*  .....#*   ###   . .  .##### .#
#   * . .. .R \.     ..### .  ... *. .* . #. #####
#.   *  1##### .  \ .    #.. ..         . #    ..#
#*.\.  *..   .. .  #   . #. \ .  \..# .   #....  #
##################################################
#. .   #.* ##  #.* #.   . ...  .   .#.    ##### ##
#.# ####    . #########.######.. ..*#..*  #.    ##
# #. #.  .   . # ..# . .. #######...#.   #####  ##
# #.E#  \ .  . 4  *#  . . ##.  #\###### # #  ...##
#.#.    . * * ....*  \.   *#   ## .#. . # #  \..##
# # .       . \ .#.#########.. ##  #   *# ######.#
# # ##...  .  .  # ..  ... # * ## ##  ..# # . .  #
# .*         #  .#######. . *  #####  ...*# ...* #
#.\..  ###  *# .##   *. .## . * # .# ###. #. .   #
# \     #   *#  ##### .   .  ...    .  .  #. .   #
#. .  ..# ..D ..##..  ##     . . .  .  ..*#   ####
#.     .#.  * .########. .  \      . . * .#. .  *#
##################################################

Water 0
Flooding 1
Waterproof 5
Trampoline A targets 1
Trampoline B targets 2
Trampoline C targets 3
Trampoline D targets 4
Trampoline E targets 1
Trampoline F targets 1