####################
###3. #\\D .####. ##
#.  * #\   .  \. ..#
#  *\ #\ .R\. \ \. #
# .. .#   . \\. ####
#  .###. . .    # .#
#.\\# # \.  .\  1\\#
# . # #\ ###.. \ ###
#. \#.# \ .      # #
#  .#.#  \ \.. *\ \#
####################
#   L.#E\..#\*  #.\#
##\ . # * * \ \ #..#
##. ####\  #####  \#
## B  ##A ##  \.  *#
## \\\#.\  \\\###  #
#.\  \# 54.*\*#  #\#
# \#.*# \ . \2#  #C#
#  #..#  \   ## \# #
####################

Water 0
Flooding 2
Waterproof 5
Trampoline A targets 1
Trampoline B targets 2
Trampoline C targets 3
Trampoline D targets 4
Trampoline E targets 5