###########
#\\\\\\\\\#
##### #####
#   .*.   #
#    #    #
#    #    #
#    R    #
#         #
#         #
#########L#