#L################################
#         \   \   \   \   \      #
#*************     **************#
#********************************#
#********************************#
#**************** ***************#
#********************************#
#********************************#
#********************************#
#              *                 #
#                                #
#                                #
#                                #
#                                #
#                                #
#                                #
#                                #
#                                #
#                                #
#                                #
#               R                #
##################################