#L################################################################
#         \   \   \   \   \                                      #
#****************************************************************#
#****************************************************************#
#****************************************************************#
#****************************************************************#
#****************************************************************#
#****************************************************************#
#****************************************************************#
#****************************************************************#
#****************************************************************#
#****************************************************************#
#****************************************************************#
#****************************************************************#
#****************************************************************#
#****************************************************************#
#****************************************************************#
#****************************************************************#
#****************************************************************#
#****************************************************************#
#****************************************************************#
#****************************************************************#
#****************************************************************#
#****************************************************************#
#****************************************************************#
#****************************************************************#
#              *                                                 #
#                                                                #
#                                                                #
#                                                                #
#                                                                #
#                                                                #
#                                                                #
#                                                                #
#                                                                #
#                                                                #
#                                                                #
#                                                                #
#                                                                #
#                                                                #
#                                                                #
#                                                                #
#                                                                #
#                                                                #
#                                                                #
#                                                                #
#                                                                #
#                                                                #
#                                                                #
#                                                                #
#                                                                #
#                                                                #
#                                                                #
#                                                                #
#                                                                #
#                                                                #
#                                                                #
#                                                                #
#                                                                #
#                                                                #
#                                                                #
#                                                                #
#                                                                #
#                                                                #
#                                                                #
#                                                                #
#                                                                #
#                                                                #
#                                                                #
#                                                                #
#                                                                #
#                                                                #
#                                                                #
#                                                                #
#                                                                #
#                                                                #
#                                                                #
#                                                                #
#                                                                #
#                                                                #
#                                                                #
#                                                                #
#                                                                #
#                                                                #
#                                                                #
#                                                                #
#                                                                #
#                                                                #
#                                                                #
#                                                                #
#                                                                #
#                                                                #
#                                                                #
#                                                                #
#                                                                #
#                                                                #
#                                                                #
#               R                #
##################################