#############################
#R                          L
# # # # # # # # # # # # # #\#
# # # # # # # # # # # # # # #
# # # # # # # # # # # # # # #
# # # # # # # # # # # # #\# #
# # # # # # # # # # # # # # #
# # # # # # # # # # # # # # #
# # # # # # # # # # # #\# # #
# # # # # # # # # # # # # # #
# # # # # # # # # # # # # # #
# # # # # # # # # # #\# # # #
# # # # # # # # # # # # # # #
# # # # # # # # # # # # # # #
# # # # # # # # # #\# # # # #
# # # # # # # # # # # # # # #
# # # # # # # # # # # # # # #
# # # # # # # # #\# # # # # #
# # # # # # # # # # # # # # #
# # # # # # # # # # # # # # #
# # # # # # # #\# # # # # # #
# # # # # # # # # # # # # # #
# # # # # # # # # # # # # # #
# # # # # # #\# # # # # # # #
# # # # # # # # # # # # # # #
# # # # # # # # # # # # # # #
# # # # # #\# # # # # # # # #
# # # # # # # # # # # # # # #
# # # # # # # # # # # # # # #
# # # # #\# # # # # # # # # #
# # # # # # # # # # # # # # #
# # # # # # # # # # # # # # #
# # # #\# # # # # # # # # # #
# # # # # # # # # # # # # # #
# # # # # # # # # # # # # # #
# # #\# # # # # # # # # # # #
# # # # # # # # # # # # # # #
# # # # # # # # # # # # # # #
# #\# # # # # # # # # # # # #
# # # # # # # # # # # # # # #
# # # # # # # # # # # # # # #
#\# # # # # # # # # # # # # #
#############################