############L###############
#                          #
#                          #
#**************************#
#**************************#
#**************************#
#                          #
#**************************#
#**************************#
#**************************#
#**************************#
#**************************#
############   #############
#                          #
#                          #
#                          #
#                          #
#                          #
#\\\\\\\                   #
#\\\\\\\                   #
#\\\\\\\                   #
#\\\\\\\                   #
#R\\\\\\                   #
############################