######
#* *R#
#* *.#
#\ * #
L\ .\#
######