##################
#\            *# #
#             *# #
#             *#\#
#         R      #
#              # #
##################