#####################
#\               *# #
#                 # #
#                 #\#
#            R      #
#####################