################################L#
#  R                             #
#                                #
#                                #
#                                #
#                                #
#                                #
#                                #
#************** *****************#
#************** *****************#
#************** *****************#
#************** *****************#
#************** *****************#
#************** *****************#
#************** *****************#
#************** *****************#
#************** *****************#
#************** *****************#
#************** *****************#
#************** *****************#
##################################