##################################
#  R                    *********#
#      ******           *********#
#      ******           *********#
#      ******           *********#
#      ******           *********#                                #
#      ******           *********#
#      ******           *********#
#                       ##########
#                                #
#                                #
#                                #
#                                #
#                                #
################################L#