################
#         \\\\\#
#              #
#              #
#              #
#              #
#              #
#              #
#              #
#R             #
#              #
#              #
#              #
#\\\           #
##############L#

Water 2
Flooding 3
Waterproof 3
